1 13 31
###############################
#p     fb s  1 *      * * *   #
# # # #*# # #*#*# # # #*#*#*# #
#   *     ***  *  1   *   * * #
# # # # # #*# # #*#*# # # # #*#
#f         x **  *  *         #
# # # # # # # # # #*# #*# # # #
#*  *      *  *      *        #
# # # # #*# # # #*#*# # # # # #
#* 2   *  *       *           #
# #*# # # # # # #*# # # # # # #
#           *   *  *          #
###############################