2 13 31
###############################
#p  *   b s  1 * 2 *  * * *   #
#   # #*# # #*#*# # * #*#*#*# #
#   *     ***  *      * 2 * * #
# # # # # #*# # #*#*# # # # #*#
#f   1       **  *  *   1     #
# # # # * # # # # #*# #*# # # #
#*  *      *  *      *        #
# # # # #*# # # #*#*# # # # # #
#*    **  *       *   3       #
# #*# # # # # # #*# # # # # # #
#           x   *  *          #
###############################