1 13 31
###############################
#p  *   b s  1 * 2 *  * * *   #
#   # #*# # #*#*# # * #*#*#*# #
#   *     ***  *  1   * 2 * * #
# # # # # #*# # #*#*# # # # #*#
#f   1  1  x **  *  *   1     #
# # # # * # # # # #*# #*# # # #
#*  *  1   *  *      *        #
# # # # #*# # # #*#*# # # # # #
#*  1 **  *       *   1111    #
# #*# # # # # # #*# # # # # # #
#      1    x   *  *          #
###############################