2 13 31
###############################
#p  *   b s  1 *      * * *   #
#   # #*# # #*#*# # * #*#*#*# #
#   *     ***  *      *   * * #
# # # # # #*# # #*#*# # # # #*#
#f   1       **  *  *   1     #
# # # # * # # # # #*# #*# # # #
#*  *      *  *      *        #
# # # # #*# # # #*#*# # # # # #
#*   2 *  *       *   3       #
# #*# # # # # # #*# # # # # # #
#           x   *  *          #
###############################