3 13 31
###############################
#p  *   b s    *      * * *   #
#   # #*# # #*#*# # * #*#*#*# #
#   *     ***  *      *   * * #
# # # # # #*# # #*#*# # # # #*#
#f           **  *  *         #
# # # # * # # # # #*# #*# # # #
#*  *      *  *      *        #
# # # # #*# # # #*#*# # # # # #
#*     *  *       *           #
# #*# # # # # # #*# # # # # # #
#           x   *  *        4 #
###############################