3 13 31
###############################
#p  *   b s    *   4  * * *   #
#   # #*# # #*#*# # * #*#*#*# #
#   *     ***  *      *   * * #
# # # # # #*# # #*#*# # # # #*#
#f           **  *  *         #
# # # # * # # # # #*# #*# # # #
#*  *      *  *      *        #
# # # # #*# # # #*#*# # # # # #
#*     *  *       *           #
# #*# # # # # # #*# # # # # # #
#           x   *  *          #
###############################